111111111111111111111111111111
1E11C1111111111C11111C11111111
11111111111111111111111CCC1111
111111111111111111111111111111
1P1111111C11C11111111111111111
111111111111111111111111111111
