00000000000000000000000000
0E00C0000000000C00000C0000
00000000000000000000000CC0
00000000000000000000000000
0P0000000C00C0000000000000
00000000000000000000000000
