111111111111111111111111111111
1E00C0000000000C00000C00000001
10100101001000001010010CCC0001
101001001010101000100100000001
1P0000000C00C00000000000000001
111111111111111111111111111111
