111111111111111111111111111111
1E00C0000000000C00000C00011111
10100101001000001010010CCC11
10100100101010100010010000011
1P0000000C00C0000000000011111
111111111111111111111111111111
