111111111111111111111111111111
1E10C0000000000C00000C000001C1
10100101001000001010010CCC0111
101001001110101000100100000001
1P0000001C10C00000000000000001
111111111111111111111111111111
