111111111111111111111111111111
100000000000000000000000000C01
101101010010C0001110011C010101
101001001010101001000100C00101
100E00000000000000C010000001P1
111111111111111111111111111111
